NO assets/cat1.png
SO assets/cat2.png
WE assets/cat3.png
EA assets/cat4.png



F 139,69,19
C 135, 206, 235

               1111111
               1000001
               1011101
               1011101
               1011101
               1011101
               1011101
               1011101
        1111111101110111111111
        1000000001110000011
        101100000111000001 111111   
        1001000001100000011111111111111111111111111111111111111111111111111111111      
11111111101100000111000E000000000000000000000000000000000000000000000000000000001
100000000011000001111000011111111111111111111111111111111111111111111111111111111    
11110111111111011110000010001
11110111111111011111010010001
11000000110101011110000010001
10000000000000001110000010001
10000000000000001111010010001
1100000111010001111101111001111
11110111 1110100000000000001
11111111 1111111111111111111


