NO assets/cat1.png
SO assets/cat2.png
WE assets/cat3.png
EA assets/cat4.png



F 139,69,19
C 135, 206, 235


        11111111111111111111111   
        1000000001110000011       
        101100000111000001 111111 
        1001000001100000011100001 
111111111011000001110000000000001 
100000000011000001111110111111111 
11110111111111000000000000001     
11110111111111000000000000001     
11000000110101011110000000111     
100000000000000011100E0000001     
10000000000000001111010010001     
1100000111010101111101111001111   
11110111 1110101111111010001      
11111111 1111111111111111111 