NO assets/cat1.png
SO assets/cat2.png
WE assets/cat3.png
EA assets/cat4.png



F 139,69,19
C 135, 206, 235

11111111
10000001
10000001
10010001
10001001
10000001
1E000001
10000001
10001001
10010001
10000001
10000001
11111111

