NO assets/cat1.png2
NO assets/cat1.png
NO assets/cat2.png

WE assets/west_no_perm.png
EA assets/not_a_png.png



F 250,255,2552333333333333333322222
C 255,0 ,0d
C 255,0 ,0


        11111111111111111111111   
        0000000001110000011       
        101100000111000001 111111 
        1001000001100000011100001 
111111111011000001110000000000001 
100000000011000001111110111111111 
11110111111111000000000000001     
11110111111111000000000000001     

11000000110101011110000000111     
100000000000000011100EE000001     
10000000000000001111010010001     
1100000111010101111101111001111   
11110111 1110101111111010001      
11111111 1111111111111111111 
